d00mmmmm0m00mmm
0m00000m0mm0m00
00mm0m000m0000m
m000mmmm000mmmm
000m00000mmm00m
mm0mmmm0mm000mm
000mmm00000mmmm
0m000mm0m0mm00m
0mm0m000m0000mm
mmm00mmmm0mmmmm
mmm0mm0m00mm00m
m000m00m0mm00mm
00mm00m00000mmm
m0mmm0mm0mm0mmm
m00000mm00m000a
